lipreading-missing-words_0au8m/the_workmen_repaired_the_roof.jen1.mp4	roof
lipreading-missing-words_0au8m/what_are_your_plans_for_the_evening.garrett1.mp4	evening
lipreading-missing-words_0au8m/do_you_know_how_much_it_costs.garrett1.mp4	how
lipreading-missing-words_0au8m/whats_the_name_of_the_company_you_work_for.garrett1.mp4	for
lipreading-missing-words_0au8m/would_you_take_a_message_please.garrett1.mp4	please
lipreading-missing-words_0au8m/how_would_you_like_to_pay.jen1.mp4	like
lipreading-missing-words_0au8m/no_thats_not_what_i_meant.garrett1.mp4	not
lipreading-missing-words_0au8m/why_dont_we_go_out_for_supper.garrett1.mp4	supper
lipreading-missing-words_0au8m/the_car_needs_a_safety_inspection.jen1.mp4	needs
lipreading-missing-words_0au8m/whats_your_first_name.garrett1.mp4	1st
lipreading-missing-words_rjjzq/are_you_allergic_to_anything.garrett1.mp4	anything
lipreading-missing-words_rjjzq/they_are_expecting_a_large_crowd.garrett1.mp4	they
lipreading-missing-words_rjjzq/that_song_brings_back_memories.garrett1.mp4	brings
lipreading-missing-words_rjjzq/do_you_know_how_to_cook.garrett1.mp4	how
lipreading-missing-words_rjjzq/my_car_is_in_the_garage.nicole1.mp4	car
lipreading-missing-words_rjjzq/he_bought_his_wife_a_new_coat.jen1.mp4	bought
lipreading-missing-words_rjjzq/the_squeaky_wheel_gets_the_grease.jen1.mp4	grease
lipreading-missing-words_rjjzq/can_you_help_me.garrett1.mp4	help
lipreading-missing-words_rjjzq/is_this_the_bus_to_new_york.garrett1.mp4	york
lipreading-missing-words_d8npt/your_shoes_are_under_the_bed.jen1.mp4	shoes
lipreading-missing-words_d8npt/be_careful_crossing_the_street.jen1.mp4	careful
lipreading-missing-words_d8npt/she_said_that_she_was_hungry.jen1.mp4	said
lipreading-missing-words_d8npt/please_turn_the_radio_off.nicole1.mp4	please
lipreading-missing-words_d8npt/its_on_7th_street.nicole1.mp4	street
lipreading-missing-words_d8npt/great.garrett1.mp4	great
lipreading-missing-words_d8npt/nice_to_meet_you.nicole1.mp4	meet
lipreading-missing-words_d8npt/my_brother_bought_a_new_car.garrett1.mp4	brother
lipreading-missing-words_d8npt/what_do_you_want_for_breakfast.garrett1.mp4	breakfast
lipreading-missing-words_fo3aj/i_have_to_go_to_the_pharmacy.jen1.mp4	pharmacy
lipreading-missing-words_fo3aj/on_the_second_floor.nicole1.mp4	2nd
lipreading-missing-words_fo3aj/have_you_seen_the_doctor.garrett1.mp4	seen
lipreading-missing-words_fo3aj/did_you_hear_the_weather_forecast.garrett1.mp4	forecast
lipreading-missing-words_fo3aj/good_idea.jen1.mp4	good
lipreading-missing-words_fo3aj/theres_no_place_like_home.jen1.mp4	place
lipreading-missing-words_fo3aj/where_are_the_tickets_for_the_ball_game.garrett1.mp4	tickets
lipreading-missing-words_fo3aj/thank_you_for_the_birthday_card.jen1.mp4	thank
lipreading-missing-words_fo3aj/the_book_is_next_to_the_table.nicole1.mp4	book
lipreading-missing-words_fo3aj/how_do_you_do.jen1.mp4	how
lipreading-missing-words_8odvf/its_more_than_5_dollars.nicole1.mp4	than
lipreading-missing-words_8odvf/whats_the_address.nicole1.mp4	address
lipreading-missing-words_8odvf/where_are_you.jen1.mp4	where
lipreading-missing-words_8odvf/i_have_to_pick_up_a_package.jen1.mp4	package
lipreading-missing-words_8odvf/he_wasnt_hurt_in_the_accident.jen1.mp4	hurt
lipreading-missing-words_8odvf/could_you_buy_me_a_loaf_of_bread.garrett1.mp4	loaf
lipreading-missing-words_8odvf/good_afternoon.nicole1.mp4	afternoon
lipreading-missing-words_8odvf/a_group_of_fans_rushed_onto_the_field.nicole1.mp4	fans
lipreading-missing-words_8odvf/where_do_you_live.garrett1.mp4	live
lipreading-missing-words_8odvf/have_you_eaten_at_that_restaurant.garrett1.mp4	eaten
